The player has the default description.
Thoroughfare has no description.
Zimmermann's Hardware Store has no description.
Hoover's Liquor and Cigar store has no description.
Dodge Town has no description.
Great Western Cattle Trail has no description.
bank in Abilene has no description.
dinner has no description.
fork has no description.
steak has no description.
bull's horns has no description.
rickety chairs and tables has no description.
wall has no description.

In 1878, the American Frontier is still very much alive. Especially so in the new settlement called Dodge Town. As the endpoint of the Great Western Cattle Trail, it is nicknamed the Queen of the Cow Cities. Founded only six years ago, Dodge Town is growing rapidly and known as a true frontier settlement.

You are Glen "The Gentleman" Fletcher, outlaw by name, gentleman by nature.  Only two days ago you robbed a bank in Abilene and decided to lay low for a while in this interesting town. You have arrived safely, but you have one pressing need: you are very hungry and need some food as soon as possible.

Travelers on the road have suggested dinner in the Long Branch Saloon. 

 
Dinner at the Long Branch Saloon
An adventure on the American Frontier by Publysher
Release 1 / Serial number 121107 / Inform 7 build 6G60 (I6/v6.32 lib 6/12N) SD

Long Branch Saloon
The saloon is dominated by a long bar to the right. Behind the bar, a few paintings try to liven up the place, accompanied by the obligatory pair of bull's horns.

At the back of the saloon a few rickety chairs and tables have been haphazardly put down. Here too, a half-hearted attempt to liven up the place has been made by adding a few paintings. Below the paintings you can see today's menu. 

You can see a barman here.

Exits: outside.

You can review your surroundings at any time by typing LOOK. Try it -- type LOOK now. (Or, if you don't need instructions, you can turn the tutorial off by typing TUTORIAL MODE OFF.)

>look
Excellent -- LOOK will print a description of your environment, like so:

Long Branch Saloon
The saloon is dominated by a long bar to the right. Behind the bar, a few paintings try to liven up the place, accompanied by the obligatory pair of bull's horns.

At the back of the saloon a few rickety chairs and tables have been haphazardly put down. Here too, a half-hearted attempt to liven up the place has been made by adding a few paintings. Below the paintings you can see today's menu. 

You can see a barman here.

Exits: outside.

Individual objects have descriptions, too. You can find out more by examining them, as in EXAMINE THE PAINTINGS.

>x paintings
No.
Individual objects have descriptions, too. You can find out more by examining them, as in EXAMINE THE PAINTINGS.

>examine the paintings
Very good. Since you're likely to examine things frequently, you can also abbreviate this command as X, as in X the rickety chairs and tables.

It's not that the paintings are ugly, but they manage to hurt the eye nevertheless.

Now, it turns out that you're holding something. To find out what, try typing INVENTORY.

>inventory
Right! In the future, you can also shorten this command to INV or just I. As you see, it will print out a description of what you've got:

You are carrying:
  a gun
  a knife
  an unlimited amount of money

If you want to get rid of something that you're holding you can always drop it, like this: DROP THE GUN.

* * *

>drop the gun
Dropping things will move them into your environment, like this:

You carefully place the gun on the ground.

You can pick things up when you see them, like this: TAKE GUN.

>take gun
Well done. Now you'll get a message to tell you whether you succeeded in picking up something:

You pick up the gun, being careful not to harm anyone in the process.

And that covers most of what you need to know! There are lots of other verbs you can type as you go along, but you'll likely be able to guess them from context. Don't be afraid to experiment with new actions.

To stop the game, type QUIT; to save your current position, type SAVE. RESTORE allows you to bring back a game you have previously saved, and RESTART starts the game over again at the beginning.

* * *

>n
Long Branch Saloon
Exits: south to The Thoroughfare.

>s
The Thoroughfare
Exits: west, east and north to the Long Branch Saloon.

>e
The Thoroughfare
Exits: west to The Thoroughfare and north.

>n
Hoover's Liquor and Cigar store
Exits: south to The Thoroughfare.

>s
The Thoroughfare
Exits: west to The Thoroughfare and north to the Hoover's Liquor and Cigar store.

>w
The Thoroughfare
Exits: west, east to The Thoroughfare and north to the Long Branch Saloon.

>w
The Thoroughfare
Exits: east to The Thoroughfare and north.

>n
Zimmermann's Hardware Store
Exits: south to The Thoroughfare.

>s
The Thoroughfare
Exits: east to The Thoroughfare and north to the Zimmermann's Hardware Store.

* * *

>look at cattle
You can't see any such thing.

>look at saloon
You can't see any such thing.

>look at passers-by
You can't see any such thing.

>look at sherrif
You can't see any such thing.

* * *

>examine the long bar
Very good. Since you're likely to examine things frequently, you can also abbreviate this command as X, as in X the gun.

Yes, this is a bar.

Now, it turns out that you're holding something. To find out what, try typing INVENTORY.

>inventory
Right! In the future, you can also shorten this command to INV or just I. As you see, it will print out a description of what you've got:

You are carrying:
  a gun
  a knife
  an unlimited amount of money

If you want to get rid of something that you're holding you can always drop it, like this: DROP THE GUN.

* * *

>drop the gun
Dropping things will move them into your environment, like this:

You carefully place the gun on the ground.

You can pick things up when you see them, like this: TAKE GUN.

>take gun
Well done. Now you'll get a message to tell you whether you succeeded in picking up something:

You pick up the gun, being careful not to harm anyone in the process.

To move from place to place, you can use the compass directions (NORTH, SOUTH, EAST, WEST, as well as NORTHEAST, NORTHWEST, etc.) 

From here, try OUTSIDE.

>outside
Nice work!

Not without your dinner.

And that covers most of what you need to know! There are lots of other verbs you can type as you go along, but you'll likely be able to guess them from context. Don't be afraid to experiment with new actions.

To stop the game, type QUIT; to save your current position, type SAVE. RESTORE allows you to bring back a game you have previously saved, and RESTART starts the game over again at the beginning.

* * *

>inventory
Right! In the future, you can also shorten this command to INV or just I. As you see, it will print out a description of what you've got:

You are carrying:
  a gun
  a knife
  an unlimited amount of money

If you want to get rid of something that you're holding you can always drop it, like this: DROP THE GUN.

>drop the unlimited amount of money
Dropping things will move them into your environment, like this:

You worked hard to earn this money. Dropping it seems kind of pointless.

You can pick things up when you see them, like this: TAKE GUN.

>take gun
Well done. Now you'll get a message to tell you whether you succeeded in picking up something:

You already have that.

To move from place to place, you can use the compass directions (NORTH, SOUTH, EAST, WEST, as well as NORTHEAST, NORTHWEST, etc.) 

From here, try OUTSIDE.

>outside
Good! Like other often-used instructions, compass directions can be abbreviated down to N, S, E, W, NE, NW, and so on. UP and DOWN are also possible -- keep an eye on room descriptions in order to learn more about where you can go and when. 

As soon as you enter a new room, you'll get a description of what's there, like this:

Not without your dinner.

Thoroughfare
Exits: inside to the Long Branch Saloon.

And that covers most of what you need to know! There are lots of other verbs you can type as you go along, but you'll likely be able to guess them from context. Don't be afraid to experiment with new actions.

To stop the game, type QUIT; to save your current position, type SAVE. RESTORE allows you to bring back a game you have previously saved, and RESTART starts the game over again at the beginning.

* * *

>inventory
Right! In the future, you can also shorten this command to INV or just I. As you see, it will print out a description of what you've got:

You are carrying:
  a gun
  a knife
  an unlimited amount of money

If you want to get rid of something that you're holding you can always drop it, like this: DROP THE GUN.

>drop the knife
Dropping things will move them into your environment, like this:

You carefully place the knife on the ground.

You can pick things up when you see them, like this: TAKE GUN.

>take gun
Well done. Now you'll get a message to tell you whether you succeeded in picking up something:

You already have that.

To move from place to place, you can use the compass directions (NORTH, SOUTH, EAST, WEST, as well as NORTHEAST, NORTHWEST, etc.) 

From here, try OUTSIDE.

>take knife
Sorry, that's not it.
To move from place to place, you can use the compass directions (NORTH, SOUTH, EAST, WEST, as well as NORTHEAST, NORTHWEST, etc.) 

From here, try OUTSIDE.

>outside
Good! Like other often-used instructions, compass directions can be abbreviated down to N, S, E, W, NE, NW, and so on. UP and DOWN are also possible -- keep an eye on room descriptions in order to learn more about where you can go and when. 

As soon as you enter a new room, you'll get a description of what's there, like this:

Not without your dinner.

And that covers most of what you need to know! There are lots of other verbs you can type as you go along, but you'll likely be able to guess them from context. Don't be afraid to experiment with new actions.

To stop the game, type QUIT; to save your current position, type SAVE. RESTORE allows you to bring back a game you have previously saved, and RESTART starts the game over again at the beginning.

>restart
Are you sure you want to restart?

>yes
The player has the default description.
Thoroughfare has no description.
Zimmermann's Hardware Store has no description.
Hoover's Liquor and Cigar store has no description.
Dodge Town has no description.
Great Western Cattle Trail has no description.
bank in Abilene has no description.
dinner has no description.
fork has no description.
steak has no description.
bull's horns has no description.
rickety chairs and tables has no description.
wall has no description.

In 1878, the American Frontier is still very much alive. Especially so in the new settlement called Dodge Town. As the endpoint of the Great Western Cattle Trail, it is nicknamed the Queen of the Cow Cities. Founded only six years ago, Dodge Town is growing rapidly and known as a true frontier settlement.

You are Glen "The Gentleman" Fletcher, outlaw by name, gentleman by nature.  Only two days ago you robbed a bank in Abilene and decided to lay low for a while in this interesting town. You have arrived safely, but you have one pressing need: you are very hungry and need some food as soon as possible.

Travelers on the road have suggested dinner in the Long Branch Saloon. 

 
Dinner at the Long Branch Saloon
An adventure on the American Frontier by Publysher
Release 1 / Serial number 121107 / Inform 7 build 6G60 (I6/v6.32 lib 6/12N) SD

Long Branch Saloon
The saloon is dominated by a long bar to the right. Behind the bar, a few paintings try to liven up the place, accompanied by the obligatory pair of bull's horns.

At the back of the saloon a few rickety chairs and tables have been haphazardly put down. Here too, a half-hearted attempt to liven up the place has been made by adding a few paintings. Below the paintings you can see today's menu. 

You can see a barman here.

Exits: outside.

You can review your surroundings at any time by typing LOOK. Try it -- type LOOK now. (Or, if you don't need instructions, you can turn the tutorial off by typing TUTORIAL MODE OFF.)

* * *

>examine the barman
Very good. Since you're likely to examine things frequently, you can also abbreviate this command as X, as in X the bull's horns.

This guy looks like he has been standing behind the bar for at least three days straight without any sleep. His handlebar moustache is yellow with nicotine stains.

Now, it turns out that you're holding something. To find out what, try typing INVENTORY.

* * *

>ask barman about steak
You don't what to say about the steak.

>x menu
"Today: steak," someone has written. Catchy and to the point.

>ask barman about steak
"Here you are, one of the finest steaks in Dodge Town".

>inventory
You are carrying:
  a steak
  a gun
  a knife
  an unlimited amount of money

>eat steak
You eat the steak. Not bad.

* * *

>x
What do you want to examine?

>x saloon
The exterior of the saloon.

* * *

>ask barman about dinner
"Barman, I'd like some food," you say.  

"Some food?," the barman replies, "We don't serve no f***ing some food. Check the f***ing menu and make up your mind."

* * *

>go outside
Not without your dinner.

>x menu
"Today: steak," someone has written. Catchy and to the point.

>ask barman about steak
"Here you are, sir, one of the finest steaks in Dodge Town. Slaughtered and prepared for your f***ing pleasure."

>go outside
Not without your dinner.

>eat steak
Eating steak without a fork? You might be an outlaw, but you are no barbarian!

>go outside
Thoroughfare
Exits: inside to the Long Branch Saloon.

* * *

>x sign
The sign reads: "Dodge City 
 The carrying of Fire Arms is prohibited. 
 Try Prickly Ash Bitters!"

>x
(the sign)
The sign reads: "Dodge City 
 The carrying of Fire Arms is prohibited. 
 Try Prickly Ash Bitters!"

>look around
That noun did not make sense in this context.

>look
The Thoroughfare
You can see a sign here.

Exits: west, east to the Road to Abilene and north.

>w
The Thoroughfare
Exits: east to The Thoroughfare, west and north.

>n
Long Branch Saloon
The interior of the saloon.

Exits: south to The Thoroughfare.

* * *

>read sign
The sign reads: "Dodge City

The carrying of Fire Arms is prohibited.

Try Prickly Ash Bitters!"

* * *

>go east
You don't want to go there.

>x sign
Dodge City

The carrying 
 of Fire Arms 
 is prohibited

Try 
 Prickly Ash 
 Bitters

* * *

>east
You don't want to go there.

* * *

>x signs
That noun did not make sense in this context.

>x sign
Dodge City

Check your guns.

Try Prickly Ash Bitters

* * *

>ask barman about food
"Barman, I'd like some food," you say.  

"Some food?," the barman replies, "We don't serve no f***ing some food. Look at the f***ing menu and make up your mind."

>look at the menu
"Today: steak," someone has written. Catchy and to the point.

>ask barman about steak
"Here you are, sir, one of the finest steaks in Dodge Town. Slaughtered and prepared for your f***ing pleasure."

* * *

>showme steak
steak - thing
location: out of play
singular-named, improper-named; unlit, edible, portable, unseen, unfamiliar
printed name: "steak"
printed plural name: none
indefinite article: none
description: none
initial appearance: none

>ask barman about steak
You don't what to say about the steak.

* * *

>x menu
"Today: steak," someone has written. Catchy and to the point.

>ask barman about steak
The barman shakes his head. "I don't know anything about that."

* * *

>extensions
That's not a verb I recognise.

>?
That's not a verb I recognise.