In 1878, the American Frontier is still very much alive. Especially so in the new settlement called Dodge Town. As the endpoint of the Great Western Cattle Trail, it is nicknamed the Queen of the Cow Cities. Founded only six years ago, Dodge Town is growing rapidly and known as a true frontier settlement.

You are Glen "The Gentleman" Fletcher, outlaw by name, gentleman by nature.  Only two days ago you robbed a bank in Abilene and decided to lay low for a while in this interesting town. You have arrived safely, but you have one pressing need: you are very hungry and need some food as soon as possible.

Travelers on the road have suggested dinner in the Long Branch Saloon. 

 
Dinner at the Long Branch Saloon
An adventure on the American Frontier by Publysher
Release 1 / Serial number 121115 / Inform 7 build 6G60 (I6/v6.32 lib 6/12N) SD

Long Branch Saloon
The saloon is dominated by a long bar to the right. Behind the bar, a few pictures try to liven up the place, accompanied by the obligatory pair of bull's horns.

At the back of the saloon a few rickety chairs and tables have been haphazardly put down. Here too, a half-hearted attempt to liven up the place has been made by adding a few pictures. Below the pictures you can see today's menu. 

You can see a barman here.

>rules
Rules tracing now switched on. Type "rules off" to switch it off again, or "rules all" to include even rules which do not apply.

>actions
Actions listing on.

>ask barman about saloon
[interrogating the barman about the Long Branch Saloon]
[interrogating the barman about the Long Branch Saloon - succeeded]

* * *

>x barman
This guy looks like he has been standing behind the bar for at least three days straight without any sleep. His moustache is yellow with nicotine stains.

>test part1
(Testing.)

>[1] go outside
Not without your dinner.

>[2] ask barman about dinner
You approach the barman: "Good afternoon".

"A good afternoon to you as well, sir. How may I help you? "

"I'd like some food," you say.  

"But of course," the barman replies, "such a desire is not unheard of. But could you be so kind as to first make a choice from our menu?"

>[3] ask barman about menu
"Can you tell me more about the menu?" you ask. 

 "Considering the multitude of choices presented on our menu, I'd suggest you examine the menu yourself."

>[4] x menu
"Today: steak," someone has written. Catchy and to the point.

>[5] ask barman about steak
"One steak please," you ask. 

"STEAK!," the barman shouts at a hidden back room. A few moments later, the cook scurries out of the back room and presents a large grilled piece of meat. 

 The barman slams the steak on a plate. "Here you are, sir, one of the finest steaks in Dodge Town. Recently slaughtered and lovingly prepared for your pleasure."

The barman hands you a steak.

>[6] ask barman about steak
"One steak please," you ask. 

"I'm afraid I've already given you the last steak available."

>[7] drop steak
Why would you want to drop such a lovely steak?

>[8] eat steak
You notice that you don't have a fork on you. And let's be honest: Eating steak without a fork? You might be an outlaw, but you are no barbarian!

>[9] ask barman about fork
I'd like a fork to eat this," you suggest.

"A fork?", the barman responds. If this were a famous and fancy hotel we might comply with your wishes. But this is just a lowly saloon. You might want to go outside, and then visit the hardware store.

>[10] go outside

The Thoroughfare
You find yourself in the busiest street of Dodge Town. Every day, hundreds of cows are driven through this street to the cattle market. The thoroughfare continues to the east and to the west.

Right now, you are standing in front of the Long Branch Saloon.

You can see a horse here.

* * *

>ask barman about store
Which do you mean, Zimmermann's Hardware Store or Hoover's Liquor and Cigar store?

>ask barman about cigar store
You approach the barman: "Good afternoon".

"A good afternoon to you as well, sir. How may I help you? "

You ask the barman if he can tell you anything about Hoover's Liquor and Cigar store. 

outside.

* * *

>ask barman about saloon
You approach the barman: "Good afternoon".

"A good afternoon to you as well, sir. How may I help you? "

"It's a nice saloon you've got here," you state.

"Well sir, would that it were mine, but it ain't. I was here and mr. Original Owner built it and I've been manning this bar ever since, but it ain't mine."

>rules
Rules tracing now switched on. Type "rules off" to switch it off again, or "rules all" to include even rules which do not apply.

>action
That's not a verb I recognise.

* * *

>actions
Actions listing on.

* * *

>rules
Rules tracing now switched on. Type "rules off" to switch it off again, or "rules all" to include even rules which do not apply.

* * *

>test part1
(Testing.)

>[1] go outside
Not without your dinner.

>[2] ask barman about dinner
You approach the barman: "Good afternoon".

"A good afternoon to you as well, sir. How may I help you? "

"I'd like some food," you say.  

"But of course," the barman replies, "such a desire is not unheard of. But could you be so kind as to first make a choice from our menu?"

>[3] ask barman about menu
"Can you tell me more about the menu?" you ask. 

 "Considering the multitude of choices presented on our menu, I'd suggest you examine the menu yourself."

>[4] x menu
"Today: steak," someone has written. Catchy and to the point.

>[5] ask barman about steak
"One steak please," you ask. 

"STEAK!," the barman shouts at a hidden back room. A few moments later, the cook scurries out of the back room and presents a large grilled piece of meat. 

 The barman slams the steak on a plate. "Here you are, sir, one of the finest steaks in Dodge Town. Recently slaughtered and lovingly prepared for your pleasure."

The barman hands you a steak.

>[6] ask barman about steak
"One steak please," you ask. 

"I'm afraid I've already given you the last steak available."

>[7] drop steak
Why would you want to drop such a lovely steak?

>[8] eat steak
You notice that you don't have a fork on you. And let's be honest: Eating steak without a fork? You might be an outlaw, but you are no barbarian!

>[9] ask barman about fork
I'd like a fork to eat this," you suggest.

"A fork?", the barman responds. If this were a famous and fancy hotel we might comply with your wishes. But this is just a lowly saloon. You might want to go outside, and then visit the hardware store.

>[10] go outside

The Thoroughfare
You find yourself in the busiest street of Dodge Town. Every day, hundreds of cows are driven through this street to the cattle market. The thoroughfare continues to the east and to the west.

Right now, you are standing in front of the Long Branch Saloon.

You can see a horse here.

>ask man about infestation
You can't see any such thing.

>west
The Thoroughfare
The western part of the thoroughfare is just as busy as the central part which lies to the east. To the west you can see Boot Hill's Cemetary.

You are standing in front of Zimmermann's Hardware Store; it seems to be closed though. A desolate looking man is standing next to the entrance.

On the door is a sign.

>ask man about shop
You approach the desolate looking man.

You carefully broach the subject of the hardware store. The desolate looking man takes deep breath, composes himself, and starts to talk. 

"Let me introduce myself; my name is Mr. Zimmermann. The hardware store you are looking at has been my pride and joy for years; I started this store singlehandedly when Dodge Town was founded four years ago. Since that time, I have supplied the local populace and travelers alike with a multitude of items and goods. 

But now the strangest of events had caused me to close the store. You see, my store has been overrun by bunnies. And when I say overrun, I refer to an infestation of biblical proportions. The little buggers are everywhere: on the floor, in the cupboards, behind the counter, yes even my cellar has not been spared.

And with me being as allergic to bunnies as a priest is to sin, I had no other option but to close down business."

>east
The Thoroughfare
You find yourself in the busiest street of Dodge Town. Every day, hundreds of cows are driven through this street to the cattle market. The thoroughfare continues to the east and to the west.

Right now, you are standing in front of the Long Branch Saloon.

You can see a horse here.

>west
The Thoroughfare
The western part of the thoroughfare is just as busy as the central part which lies to the east. To the west you can see Boot Hill's Cemetary.

You are standing in front of Zimmermann's Hardware Store; it seems to be closed though. Mr. Zimmermann is standing next to the entrance.

On the door is a sign.

>east
The Thoroughfare
You find yourself in the busiest street of Dodge Town. Every day, hundreds of cows are driven through this street to the cattle market. The thoroughfare continues to the east and to the west.

Right now, you are standing in front of the Long Branch Saloon.

You can see a horse here.

>enter saloon
Long Branch Saloon
The saloon is dominated by a long bar to the right. Behind the bar, a few pictures try to liven up the place, accompanied by the obligatory pair of bull's horns.

At the back of the saloon a few rickety chairs and tables have been haphazardly put down. Here too, a half-hearted attempt to liven up the place has been made by adding a few pictures. Below the pictures you can see today's menu. 

You can see a barman here.

>ask barman about infestation
You approach the barman: "Good afternoon".

"A good afternoon to you as well, sir. How may I help you? "

You start talking about the infestation of bunnies, but the barman shakes his head. "Not sure what I could tell you about that."

* * *

>go west
The Thoroughfare
The western part of the thoroughfare is just as busy as the central part which lies to the east. To the west you can see Boot Hill's Cemetary.

You are standing in front of Zimmermann's Hardware Store; it seems to be closed though. A desolate looking man is standing next to the entrance.

On the door is a sign.

>ask man about store
Which do you mean, Zimmermann's Hardware Store or Hoover's Liquor and Cigar store?

>ask man about cigar store
You approach the desolate looking man.

You ask the desolate looking man if he can tell you anything about Hoover's Liquor and Cigar store, but the desolate looking man suggests you go east to see for yourself.

* * *

>go west
The Thoroughfare
The western part of the thoroughfare is just as busy as the central part which lies to the east. To the west you can see Boot Hill's Cemetary.

You are standing in front of Zimmermann's Hardware Store; it seems to be closed though. A desolate looking man is standing next to the entrance.

On the door is a sign.

>showme mr zimmermann
desolate looking man - man
location: in the The Thoroughfare
singular-named, improper-named, unnotable; unlit, inedible, fixed in place, scenery, seen, unfamiliar, previously-mentioned; male
printed name: "desolate looking man"
printed plural name: "men"
indefinite article: none
associated image: none
description: "He looks like he can burst into tears at any moment."
initial appearance: none
carrying capacity: 100
topic list: Table of Mr Zimmermann Topics
default greeting: "You approach the desolate looking man."

>ask man about shop
You approach the desolate looking man.

You carefully broach the subject of the hardware store. The desolate looking man takes deep breath, composes himself, and starts to talk. 

"The hardware store you are looking at has been my pride and joy for years; I started this store singlehandedly when Dodge Town was founded four years ago. Since that time, I have supplied the local populace and travelers alike with a multitude of items and goods. 

But now the strangest of events had caused me to close the store. You see, my store has been overrun by bunnies. And when I say overrun, I refer to an infestation of biblical proportions. The little buggers are everywhere: on the floor, in the cupboards, behind the counter, yes even my cellar has not been spared.

And with me being as allergic to bunnies as a priest is to sin, I had no other option but to close down business"

>showme man
desolate looking man - man
location: in the The Thoroughfare
singular-named, improper-named, unnotable; unlit, inedible, fixed in place, scenery, seen, unfamiliar, previously-mentioned; male
printed name: "desolate looking man"
printed plural name: "men"
indefinite article: none
associated image: none
description: "He looks like he can burst into tears at any moment."
initial appearance: none
carrying capacity: 100
topic list: Table of Mr Zimmermann Topics
default greeting: "You approach the desolate looking man."

* * *

>west
The Thoroughfare
The western part of the thoroughfare is just as busy as the central part which lies to the east. To the west you can see Boot Hill's Cemetary.

You are standing in front of Zimmermann's Hardware Store; it seems to be closed though. A desolate looking man is standing next to the entrance.

On the door is a sign.

>ask man about fork
You approach the desolate looking man.

"Can you sell me a fork?", you ask. "I'd like to eat this steak, you see."

"I would, if I could," the desolate looking man answers. "But as you can see, the shop is closed."

>ask about fork
You can't see any such thing.

>ask man about fork
"Do you anyplace else where I could get a fork?"

"Unfortunately not," the desolate looking man replies. "This is the only hardware store in town."

* * *

>west
The Thoroughfare
The western part of the thoroughfare is just as busy as the central part which lies to the east. To the west you can see Boot Hill's Cemetary.

You are standing in front of Zimmermann's Hardware Store; it seems to be closed though. A desolate looking man is standing next to the entrance.

On the door is a sign.

>ask about door
You can't see any such thing.

>ask man about sign
You approach the desolate looking man.

You start talking about the sign, but the desolate looking man shakes his head. "I don't know anything about that."

* * *

>west
The Thoroughfare
The western part of the thoroughfare is just as busy as the central part which lies to the east. To the west you can see Boot Hill's Cemetary.

You are standing in front of Zimmermann's Hardware Store; it seems to be closed though. A desolate looking man is standing next to the entrance.

On the door is a sign.

>ask man about store
Which do you mean, Zimmermann's Hardware Store or Hoover's Liquor and Cigar store?

>ask man about hardware store
You approach the desolate looking man.

You carefully broach the subject of the hardware store. The desolate looking man takes deep breath, composes himself, and starts to talk. 

"Let me introduce myself; my name is Mr. Zimmermann. The hardware store you are looking at has been my pride and joy for years; I started this store singlehandedly when Dodge Town was founded four years ago. Since that time, I have supplied the local populace and travelers alike with a multitude of items and goods. 

But now the strangest of events had caused me to close the store. You see, my store has been overrun by bunnies. And when I say overrun, I refer to an infestation of biblical proportions. The little buggers are everywhere: on the floor, in the cupboards, behind the counter, yes even my cellar has not been spared.

And with me being as allergic to bunnies as a priest is to sin, I had no other option but to close down business."

>ask man about hardware store
You carefully listen to Mr. Zimmermann talking about his woes, but the gist stays the same: the store is closed due to an infestation of bunnies.

* * *

>o west
Sorry, that can't be corrected.

>west
The Thoroughfare
The western part of the thoroughfare is just as busy as the central part which lies to the east. To the west you can see Boot Hill's Cemetary.

You are standing in front of Zimmermann's Hardware Store; it seems to be closed though. A desolate looking man is standing next to the entrance.

On the door is a sign.

* * *

>ask man about fork
You approach the desolate looking man.

"Can you sell me a fork?", you ask. "I'd like to eat this steak, you see."

"I would, if I could," the desolate looking man answers. "But as you can see, the shop is closed."

>ask man about fork
"Do you know of another place where I could get a fork?"

"Unfortunately not," the desolate looking man replies. "This is the only hardware store in town."

>ask man about fork
"Do you know of another place where I could get a fork?"

"Unfortunately not," the desolate looking man replies. "This is the only hardware store in town."

* * *

>ask barman about dinner
You approach the barman: "Good afternoon".

"A good afternoon to you as well, sir. How may I help you? "

"I'd like some food," you say.  

"But of course," the barman replies, "such a desire is not unheard of. But could you be so kind as to first make a choice from our menu?"

>x menu
"Today: steak," someone has written. Catchy and to the point.

>ask barman about steak
"One steak please," you ask. 

"STEAK!," the barman shouts at a hidden back room. A few moments later, the cook scurries out of the back room and presents a large grilled piece of meat. 

 The barman slams the steak on a plate. "Here you are, sir, one of the finest steaks in Dodge Town. Recently slaughtered and lovingly prepared for your pleasure."

The barman hands you a steak.

>eat steak
You notice that you don't have a fork on you. And let's be honest: Eating steak without a fork? You might be an outlaw, but you are no barbarian!

>ask barman about fork
I'd like a fork to eat this," you suggest.

"A fork?", the barman responds. If this were a famous and fancy hotel we might comply with your wishes. But this is just a lowly saloon. You might want to go outside, and then visit the hardware store.

>go outside
Thoroughfare
You find yourself in the busiest street of Dodge Town. Every day, hundreds of cows are driven through this street to the cattle market. The thoroughfare continues to the east and to the west.

Right now, you are standing in front of the Long Branch Saloon.

* * *

>ask barman about rabbits
There is no reply.

>ask barman about infestation
You don't what to say about the infestation.

* * *

>ask barman about hardware store
You approach the barman: "Good afternoon".

"A good afternoon to you as well, sir. How may I help you? "

You ask the barman if he can tell you anything about Zimmermann's Hardware Store, but he suggests you go outside to see for yourself.

>test part1
(Testing.)

>[1] go outside
Not without your dinner.

>[2] ask barman about dinner
"I'd like some food," you say.  

"But of course," the barman replies, "such a desire is not unheard of. But could you be so kind as to first make a choice from our menu?"

>[3] ask barman about menu
"Can you tell me more about the menu?" you ask. 

 "Considering the multitude of choices presented on our menu, I'd suggest you examine the menu yourself."

>[4] x menu
"Today: steak," someone has written. Catchy and to the point.

>[5] ask barman about steak
"One steak please," you ask. 

"STEAK!," the barman shouts at a hidden back room. A few moments later, the cook scurries out of the back room and presents a large grilled piece of meat. 

 The barman slams the steak on a plate. "Here you are, sir, one of the finest steaks in Dodge Town. Recently slaughtered and lovingly prepared for your pleasure."

The barman hands you a steak.

>[6] ask barman about steak
"One steak please," you ask. 

"I'm afraid I've already given you the last steak available."

>[7] drop steak
Why would you want to drop such a lovely steak?

>[8] eat steak
You notice that you don't have a fork on you. And let's be honest: Eating steak without a fork? You might be an outlaw, but you are no barbarian!

>[9] ask barman about fork
I'd like a fork to eat this," you suggest.

"A fork?", the barman responds. If this were a famous and fancy hotel we might comply with your wishes. But this is just a lowly saloon. You might want to go outside, and then visit the hardware store.

>[10] go outside

The Thoroughfare
You find yourself in the busiest street of Dodge Town. Every day, hundreds of cows are driven through this street to the cattle market. The thoroughfare continues to the east and to the west.

Right now, you are standing in front of the Long Branch Saloon.

You can see a horse here.

>go west
The Thoroughfare
The western part of the thoroughfare is just as busy as the central part which lies to the east. To the west you can see Boot Hill's Cemetary.

You are standing in front of Zimmermann's Hardware Store; it seems to be closed though. A desolate looking man is standing next to the entrance.

On the door is a sign.

* * *

>ask man about store
Which do you mean, Zimmermann's Hardware Store or Hoover's Liquor and Cigar store?

>ask man about hardware store
You approach the desolate looking man.

You carefully broach the subject of the hardware store. The desolate looking man takes deep breath, composes himself, and starts to talk. 

"Let me introduce myself; my name is Mr. Zimmermann. The hardware store you are looking at has been my pride and joy for years; I started this store singlehandedly when Dodge Town was founded four years ago. Since that time, I have supplied the local populace and travelers alike with a multitude of items and goods. 

But now the strangest of events had caused me to close the store. You see, my store has been overrun by bunnies. And when I say overrun, I refer to an infestation of biblical proportions. The little buggers are everywhere: on the floor, in the cupboards, behind the counter, yes even my cellar has not been spared.

And with me being as allergic to bunnies as a priest is to sin, I had no other option but to close down business"

>ask man about hardware store
You carefully broach the subject of the hardware store. Mr. Zimmermann takes deep breath, composes himself, and starts to talk. 

"The hardware store you are looking at has been my pride and joy for years; I started this store singlehandedly when Dodge Town was founded four years ago. Since that time, I have supplied the local populace and travelers alike with a multitude of items and goods. 

But now the strangest of events had caused me to close the store. You see, my store has been overrun by bunnies. And when I say overrun, I refer to an infestation of biblical proportions. The little buggers are everywhere: on the floor, in the cupboards, behind the counter, yes even my cellar has not been spared.

And with me being as allergic to bunnies as a priest is to sin, I had no other option but to close down business"

* * *

>tutorial mode on
Tutorial mode is now on.

You can review your surroundings at any time by typing LOOK. Try it -- type LOOK now. (Or, if you don't need instructions, you can turn the tutorial off by typing TUTORIAL MODE OFF.)

>look
Excellent -- LOOK will print a description of your environment, like so:

Long Branch Saloon
The saloon is dominated by a long bar to the right. Behind the bar, a few pictures try to liven up the place, accompanied by the obligatory pair of bull's horns.

At the back of the saloon a few rickety chairs and tables have been haphazardly put down. Here too, a half-hearted attempt to liven up the place has been made by adding a few pictures. Below the pictures you can see today's menu. 

You can see a barman here.

Individual objects have descriptions, too. You can find out more by examining them, as in EXAMINE PICTURES.

>examine pictures
Very good. Since you're likely to examine things frequently, you can also abbreviate this command as X, as in X the menu.

You take a close look at one of the pictures. It seems to be a photograph of general Custer.

Now, it turns out that you're holding something. To find out what, try typing INVENTORY.

>inventory
Right! In the future, you can also shorten this command to INV or just I. As you see, it will print out a description of what you've got:

You are carrying:
  a gun
  a knife
  an unlimited amount of money

If you want to get rid of something that you're holding you can always drop it, like this: DROP THE GUN.

>drop the gun
Dropping things will move them into your environment, like this:

You carefully place the gun on the ground.

You can pick things up when you see them, like this: TAKE GUN.

>take gun
Well done. Now you'll get a message to tell you whether you succeeded in picking up something:

You pick up the gun, being careful not to harm anyone in the process.

You can also converse with other people, like this: ASK BARMAN ABOUT DINNER.

>ask barman about dinner
Well spoken. If you asked about something sensible, you will get a reply.

You approach the barman: "Good afternoon".

"A good afternoon to you as well, sir. How may I help you? "

"I'd like some food," you say.  

"But of course," the barman replies, "such a desire is not unheard of. But could you be so kind as to first make a choice from our menu?"

And that covers most of what you need to know! There are lots of other verbs you can type as you go along, but you'll likely be able to guess them from context. Don't be afraid to experiment with new actions.

To stop the game, type QUIT; to save your current position, type SAVE. RESTORE allows you to bring back a game you have previously saved, and RESTART starts the game over again at the beginning.

You're on your own now.

* * *

>ask barman about cigar store
You approach the barman: "Good afternoon".

"A good afternoon to you as well, sir. How may I help you? "

You ask the barman if he can tell you anything about Hoover's Liquor and Cigar store, but the barman suggests you go outside to see for yourself.

>ask barman about saloon
"It's a nice saloon you've got here," you remark.

"Well sir, would that it were mine, but it ain't. I was here when mr. Original Owner built it not four years ago and I've been manning this bar ever since, but it ain't mine."

>test part1
(Testing.)

>[1] go outside
Not without your dinner.

>[2] ask barman about dinner
"I'd like some food," you say.  

"But of course," the barman replies, "such a desire is not unheard of. But could you be so kind as to first make a choice from our menu?"

>[3] ask barman about menu
"Can you tell me more about the menu?" you ask. 

 "Considering the multitude of choices presented on our menu, I'd suggest you examine the menu yourself."

>[4] x menu
"Today: steak," someone has written. Catchy and to the point.

>[5] ask barman about steak
"One steak please," you ask. 

"STEAK!," the barman shouts at a hidden back room. A few moments later, the cook scurries out of the back room and presents a large grilled piece of meat. 

 The barman slams the steak on a plate. "Here you are, sir, one of the finest steaks in Dodge Town. Recently slaughtered and lovingly prepared for your pleasure."

The barman hands you a steak.

>[6] ask barman about steak
"One steak please," you ask. 

"I'm afraid I've already given you the last steak available."

>[7] drop steak
Why would you want to drop such a lovely steak?

>[8] eat steak
You notice that you don't have a fork on you. And let's be honest: Eating steak without a fork? You might be an outlaw, but you are no barbarian!

>[9] ask barman about fork
I'd like a fork to eat this," you suggest.

"A fork?", the barman responds. If this were a famous and fancy hotel we might comply with your wishes. But this is just a lowly saloon. You might want to go outside, and then visit the hardware store.

>[10] go outside

The Thoroughfare
You find yourself in the busiest street of Dodge Town. Every day, hundreds of cows are driven through this street to the cattle market. The thoroughfare continues to the east and to the west.

Right now, you are standing in front of the Long Branch Saloon.

You can see a horse here.

I beg your pardon?

>go west
The Thoroughfare
The western part of the thoroughfare is just as busy as the central part which lies to the east. To the west you can see Boot Hill's Cemetary.

You are standing in front of Zimmermann's Hardware Store; it seems to be closed though. A desolate looking man is standing next to the entrance.

On the door is a sign.

>ask man about shop
You approach the desolate looking man.

You carefully broach the subject of the hardware store. The desolate looking man takes deep breath, composes himself, and starts to talk. 

"The hardware store you are looking at has been my pride and joy for years; I started this store singlehandedly when Dodge Town was founded four years ago. Since that time, I have supplied the local populace and travelers alike with a multitude of items and goods. 

But now the strangest of events had caused me to close the store. You see, my store has been overrun by bunnies. And when I say overrun, I refer to an infestation of biblical proportions. The little buggers are everywhere: on the floor, in the cupboards, behind the counter, yes even my cellar has not been spared.

And with me being as allergic to bunnies as a priest is to sin, I had no other option but to close down business"

* * *

>test all
(Testing.)

>[1] test part1
(Testing.)

>[2] go outside
Not without your dinner.

>[3] ask barman about dinner
You approach the barman: "Good afternoon".

"A good afternoon to you as well, sir. How may I help you? "

"I'd like some food," you say.  

"But of course," the barman replies, "such a desire is not unheard of. But could you be so kind as to first make a choice from our menu?"

>[4] ask barman about menu
"Can you tell me more about the menu?" you ask. 

 "Considering the multitude of choices presented on our menu, I'd suggest you examine the menu yourself."

>[5] x menu
"Today: steak," someone has written. Catchy and to the point.

>[6] ask barman about steak
"One steak please," you ask. 

"STEAK!," the barman shouts at a hidden back room. A few moments later, the cook scurries out of the back room and presents a large grilled piece of meat. 

 The barman slams the steak on a plate. "Here you are, sir, one of the finest steaks in Dodge Town. Recently slaughtered and lovingly prepared for your pleasure."

The barman hands you a steak.

>[7] ask barman about steak
"One steak please," you ask. 

"I'm afraid I've already given you the last steak available."

>[8] drop steak
Why would you want to drop such a lovely steak?

>[9] eat steak
You notice that you don't have a fork on you. And let's be honest: Eating steak without a fork? You might be an outlaw, but you are no barbarian!

>[10] ask barman about fork
I'd like a fork to eat this," you suggest.

"A fork?", the barman responds. If this were a famous and fancy hotel we might comply with your wishes. But this is just a lowly saloon. You might want to go outside, and then visit the hardware store.

>[11] go outside

Thoroughfare
You find yourself in the busiest street of Dodge Town. Every day, hundreds of cows are driven through this street to the cattle market. The thoroughfare continues to the east and to the west.

Right now, you are standing in front of the Long Branch Saloon.